30. Лексикон

E

А - значит абсент
Б - беспорядки
В - внутренности
Г - гнилые
Д - значит драка
Е - значит ехать
Ё - ёбнутый
Ж - значит жирно
З - значит злиться
И - это игорь
И кратное - йод
Л - люто
К - Калашников
М - манага
Н - наверное
О - опиаты
П - это паника
Р - расстрелы
С - сахарно
Т - Трунаев
У - убийца
Ф - это фрактал
Х - хуевый
Ц - значит целиться
Ч - значит чача
Ш - шторит
Щ - щериться
Ъ знак - значит твердый
Ы - пропустим
Ь знак - значит мягкий
Э - эмоции
Ю - юродивые
Я - значит я
